111111
1P0011
101011
10E011
100C11
111111